Country,Year,WeekOfYear,WeekStartDate,ILI_Denominator00-04,ILI_Denominator05-14,ILI_Denominator15-64,ILI_Denominator65+,ILI_DenominatorNumberOfCases,ILI00-04,ILI05-14,ILI15-64,ILI65+,ILINumberOfCases,MaxTemp,MinTemp,AvgPrec
Ireland,2006,1,2006-01-02,10192,20183,97393,15999,143767,0,0,11,3,14,77.10204081632652,30.346938775510203,20.163265306122447
Ireland,2006,2,2006-01-09,9880,19565,94412,15510,139367,1,1,13,0,15,103.9795918367347,35.87755102040816,45.285714285714285
Ireland,2006,3,2006-01-16,9997,19798,95537,15694,141026,3,2,18,2,25,98.16326530612245,50.08163265306122,24.836734693877556
Ireland,2006,4,2006-01-23,9887,19579,94480,15521,139467,2,2,18,1,23,76.85714285714286,28.32653061224489,5.7142857142857135
Ireland,2006,5,2006-01-30,10312,20421,98545,16189,145467,0,4,18,2,24,81.44897959183673,25.836734693877553,7.408163265306123
Ireland,2006,6,2006-02-06,10312,20421,98545,16189,145467,0,11,32,0,43,92.0,34.59183673469388,22.3265306122449
Ireland,2006,7,2006-02-13,9877,19559,94385,15505,139326,3,14,51,2,70,95.08163265306123,35.857142857142854,37.69387755102041
Ireland,2006,8,2006-02-20,10043,19888,95970,15766,141667,1,12,44,2,59,76.65306122448979,25.95918367346939,9.306122448979592
Ireland,2006,9,2006-02-27,10397,20590,99358,16322,146667,4,13,55,2,74,68.73469387755102,-6.6734693877551035,16.877551020408163
Ireland,2006,10,2006-03-06,9880,19565,94412,15510,139367,5,30,74,6,115,106.57142857142857,39.285714285714285,57.224489795918366
Ireland,2006,11,2006-03-13,10397,20590,99358,16322,146667,2,18,41,1,62,85.16326530612244,43.83673469387755,19.346938775510203
Ireland,2006,12,2006-03-20,11068,21918,105767,17375,156128,4,12,56,2,74,93.02040816326532,39.204081632653065,38.38775510204082
Ireland,2006,13,2006-03-27,11177,22134,106810,17546,157667,3,6,49,7,65,116.59183673469386,58.122448979591844,41.387755102040806
Ireland,2006,14,2006-04-03,11177,22134,106810,17546,157667,1,10,27,1,39,106.38775510204083,28.612244897959187,18.081632653061224
Ireland,2006,15,2006-04-10,10865,21516,103829,17057,153267,0,2,8,1,11,121.99999999999999,53.51020408163265,24.020408163265312
Ireland,2006,16,2006-04-17,10645,21081,101729,16712,150167,0,0,8,3,11,130.44897959183672,59.57142857142857,21.836734693877553
Ireland,2006,17,2006-04-24,10794,21376,103152,16945,152267,0,0,10,4,14,133.53061224489798,63.673469387755105,17.612244897959183
Ireland,2006,18,2006-05-01,10656,21102,101831,16728,150317,0,0,4,0,4,139.3877551020408,70.08163265306123,39.51020408163265
Ireland,2006,19,2006-05-08,10645,21081,101729,16712,150167,1,0,0,1,2,155.77551020408163,75.85714285714286,32.16326530612245
Ireland,2006,20,2006-05-15,10943,21671,104574,17179,154367,0,2,1,0,3,146.12244897959184,88.57142857142857,55.10204081632653
Ireland,2006,21,2006-05-22,11000,21783,105116,17268,155167,0,0,3,1,4,144.34693877551018,75.67346938775509,27.571428571428566
Ireland,2006,22,2006-05-29,10905,21595,104209,17119,153828,0,0,2,2,4,172.57142857142858,77.10204081632652,6.469387755102042
Ireland,2006,23,2006-06-05,10373,20542,99127,16284,146326,0,0,2,0,2,207.30612244897955,111.93877551020408,9.142857142857142
Ireland,2006,24,2006-06-12,11177,22134,106810,17546,157667,1,1,3,0,5,180.0408163265306,105.30612244897961,23.163265306122447
Ireland,2006,25,2006-06-19,10834,21455,103532,17008,152829,0,1,1,0,2,169.59183673469389,105.3061224489796,16.510204081632654
Ireland,2006,26,2006-06-26,9210,18238,88010,14458,129916,0,0,2,0,2,191.55102040816323,115.61224489795917,19.816326530612248
Ireland,2006,27,2006-07-03,5508,10907,52634,52634,121683,1,0,0,0,1,191.91836734693877,123.95918367346938,26.346938775510203
Ireland,2006,28,2006-07-10,9981,19765,95377,15668,140791,0,0,2,0,2,200.08163265306123,112.85714285714288,8.326530612244898
Ireland,2006,29,2006-07-17,10930,21646,104452,17159,154187,0,0,0,0,0,226.65306122448982,137.6326530612245,13.775510204081632
Ireland,2006,30,2006-07-24,10670,21130,101966,16751,150517,0,0,1,0,1,208.26530612244898,140.57142857142858,40.204081632653065
Ireland,2006,31,2006-07-31,10954,21692,104676,17196,154518,0,0,2,0,2,196.67346938775512,133.24489795918367,24.163265306122447
Ireland,2006,32,2006-08-07,10330,20457,98717,16217,145721,0,0,1,0,1,182.69387755102042,117.77551020408164,13.959183673469388
Ireland,2006,33,2006-08-14,10056,19913,96093,15786,141848,0,0,4,1,5,184.20408163265304,121.55102040816327,37.0
Ireland,2006,34,2006-08-21,10005,19812,95605,15706,141128,0,0,3,0,3,185.9591836734694,118.26530612244899,22.061224489795915
Ireland,2006,35,2006-08-28,11177,22134,106810,17546,157667,0,0,2,0,2,183.55102040816328,118.18367346938773,50.183673469387756
Ireland,2006,36,2006-09-04,11177,22134,106810,17546,157667,1,1,3,0,5,188.6734693877551,117.95918367346938,25.551020408163264
Ireland,2006,37,2006-09-11,10752,21292,102745,16879,151668,0,1,4,0,5,183.55102040816328,115.77551020408164,25.32653061224489
Ireland,2006,38,2006-09-18,11177,22134,106810,17546,157667,0,0,2,0,2,175.55102040816323,111.71428571428571,80.97959183673468
Ireland,2006,39,2006-09-25,11177,22134,106810,17546,157667,1,0,8,0,9,168.6122448979592,104.71428571428571,44.6530612244898
Ireland,2006,40,2006-10-02,11480,21350,110405,17775,161010,1,1,2,0,4,153.3469387755102,93.59183673469387,42.95918367346938
Ireland,2006,41,2006-10-09,11730,21814,112805,18162,164511,0,1,11,2,14,159.28571428571428,95.63265306122447,23.387755102040813
Ireland,2006,42,2006-10-16,11730,21814,112805,18162,164511,0,1,4,0,5,146.22448979591837,96.73469387755101,39.57142857142857
Ireland,2006,43,2006-10-23,11723,21801,112737,18151,164412,0,0,11,0,11,139.12244897959187,75.85714285714286,60.0
Ireland,2006,44,2006-10-30,11730,21814,112805,18162,164511,0,0,4,2,6,122.28571428571429,53.53061224489795,15.73469387755102
Ireland,2006,45,2006-11-06,11730,21814,112805,18162,164511,2,0,6,0,8,123.75510204081634,59.34693877551022,26.489795918367346
Ireland,2006,46,2006-11-13,11444,21284,110062,17720,160510,0,0,9,1,10,98.48979591836735,47.387755102040806,76.42857142857143
Ireland,2006,47,2006-11-20,11260,20941,108291,17435,157927,3,0,9,1,13,103.16326530612243,46.183673469387756,60.244897959183675
Ireland,2006,48,2006-11-27,11566,21509,111228,17908,162211,1,0,12,0,13,110.28571428571429,58.367346938775505,77.79591836734694
Ireland,2006,49,2006-12-04,11494,21377,110542,17798,161211,0,0,7,0,7,99.53061224489797,46.91836734693878,66.02040816326532
Ireland,2006,50,2006-12-11,11730,21814,112805,18162,164511,2,1,9,1,13,96.81632653061224,48.69387755102041,59.18367346938775
Ireland,2006,51,2006-12-18,11730,21814,112805,18162,164511,0,1,13,2,16,77.53061224489795,25.571428571428573,10.755102040816325
Ireland,2006,52,2006-12-25,11730,21814,112805,18162,164511,0,1,19,1,21,96.60714285714286,53.07142857142857,46.80357142857143
Ireland,2007,1,2007-01-01,11587,21549,111434,17941,162511,1,1,22,0,24,100.5,53.517857142857146,40.785714285714285
Ireland,2007,2,2007-01-08,11730,21814,112805,18162,164511,1,2,19,0,22,107.44897959183675,51.3469387755102,41.93877551020408
Ireland,2007,3,2007-01-15,11730,21814,112805,18162,164511,0,1,27,1,29,94.83673469387755,35.3469387755102,52.244897959183675
Ireland,2007,4,2007-01-22,11730,21814,112805,18162,164511,2,0,33,2,37,78.93877551020408,21.79591836734694,12.36734693877551
Ireland,2007,5,2007-01-29,11558,21496,111158,17897,162109,4,6,55,2,67,95.59183673469389,37.55102040816327,9.469387755102039
Ireland,2007,6,2007-02-05,11531,21446,110899,17855,161731,1,8,70,7,86,75.9591836734694,13.285714285714286,38.775510204081634
Ireland,2007,7,2007-02-12,12031,22374,115699,18628,168732,9,14,86,5,114,95.61224489795919,30.979591836734695,35.04081632653062
Ireland,2007,8,2007-02-19,11865,22066,114109,18372,166412,1,12,89,4,106,102.87755102040816,46.42857142857143,37.530612244897966
Ireland,2007,9,2007-02-26,12031,22374,115699,18628,168732,8,6,64,8,86,105.38775510204081,42.857142857142854,40.89795918367347
Ireland,2007,10,2007-03-05,12031,22374,115699,18628,168732,2,7,29,3,41,105.6938775510204,44.26530612244898,40.795918367346935
Ireland,2007,11,2007-03-12,11913,22155,114567,18446,167081,2,1,17,0,20,107.16326530612244,46.326530612244895,23.857142857142858
Ireland,2007,12,2007-03-19,12031,22374,115699,18628,168732,0,0,13,1,14,105.53061224489795,29.0,13.020408163265305
Ireland,2007,13,2007-03-26,11867,22069,114122,18374,166432,1,1,7,0,9,116.0204081632653,37.265306122448976,8.571428571428571
Ireland,2007,14,2007-04-02,12031,22374,115699,18628,168732,0,0,12,3,15,135.0204081632653,37.46938775510205,6.10204081632653
Ireland,2007,15,2007-04-09,11154,20743,107265,17270,156432,0,0,2,0,2,150.9591836734694,67.12244897959184,6.183673469387755
Ireland,2007,16,2007-04-16,11598,21569,111535,17958,162660,0,0,2,0,2,144.46938775510202,66.28571428571428,15.20408163265306
Ireland,2007,17,2007-04-23,11598,21569,111535,17958,162660,0,0,0,0,0,153.91836734693877,76.53061224489795,28.510204081632654
Ireland,2007,18,2007-04-30,11598,21569,111535,17958,162660,1,0,2,0,3,169.22448979591837,75.85714285714286,11.346938775510205
Ireland,2007,19,2007-05-07,11598,21569,111535,17958,162660,0,0,1,0,1,144.28571428571428,77.67346938775509,26.428571428571427
Ireland,2007,20,2007-05-14,11598,21569,111535,17958,162660,0,0,2,0,2,148.6326530612245,79.59183673469387,35.6530612244898
Ireland,2007,21,2007-05-21,11490,21370,110507,17792,161159,0,0,1,0,1,154.0,82.20408163265306,19.897959183673468
Ireland,2007,22,2007-05-28,11598,21569,111535,17958,162660,0,0,0,0,0,161.9387755102041,83.69387755102039,42.08163265306122
Ireland,2007,23,2007-06-04,11598,21569,111535,17958,162660,0,0,1,0,1,202.40816326530611,100.57142857142857,6.857142857142857
Ireland,2007,24,2007-06-11,11598,21569,111535,17958,162660,1,0,2,0,3,173.14285714285714,115.89795918367346,26.69387755102041
Ireland,2007,25,2007-06-18,11274,20966,108422,17456,158118,0,0,1,0,1,171.79591836734693,115.63265306122447,45.367346938775505
Ireland,2007,26,2007-06-25,11597,21568,111535,17957,162657,0,0,1,0,1,171.18367346938774,107.87755102040816,40.755102040816325
Ireland,2007,27,2007-07-02,12239,22762,117706,18951,171658,0,0,5,1,6,175.8979591836735,114.44897959183675,35.61224489795918
Ireland,2007,28,2007-07-09,12110,22523,116472,18752,169857,1,0,1,0,2,180.79591836734696,116.79591836734694,39.142857142857146
Ireland,2007,29,2007-07-16,11515,21415,110742,17829,161501,0,0,4,0,4,186.48979591836738,117.6938775510204,27.959183673469386
Ireland,2007,30,2007-07-23,11707,21772,112587,18126,164192,0,0,1,0,1,185.51020408163268,119.16326530612244,28.59183673469388
Ireland,2007,31,2007-07-30,12446,23146,119695,19271,174558,0,0,3,0,3,190.71428571428572,118.73469387755101,37.265306122448976
Ireland,2007,32,2007-08-06,12446,23146,119695,19271,174558,0,0,1,0,1,181.24489795918365,116.6938775510204,47.06122448979592
Ireland,2007,33,2007-08-13,12280,22839,118105,19015,172239,0,0,1,0,1,174.9591836734694,115.16326530612243,45.40816326530612
Ireland,2007,34,2007-08-20,12246,23146,119695,19271,174358,0,0,0,0,0,190.2244897959184,121.89795918367346,11.0
Ireland,2007,35,2007-08-27,12246,23146,119695,19271,174358,0,0,3,0,3,182.57142857142858,124.48979591836735,15.510204081632654
Ireland,2007,36,2007-09-03,12446,23146,119695,19271,174558,0,0,2,1,3,189.16326530612244,116.53061224489795,10.306122448979592
Ireland,2007,37,2007-09-10,11025,20505,106036,17072,154638,1,0,3,0,4,180.59183673469389,119.18367346938774,28.163265306122447
Ireland,2007,38,2007-09-17,12336,22942,118639,19101,173018,0,0,3,0,3,164.0612244897959,91.75510204081634,44.08163265306121
Ireland,2007,39,2007-09-24,11779,21906,113284,18239,165208,0,1,8,2,11,146.59183673469389,77.22448979591836,16.30612244897959
Ireland,2007,40,2007-10-01,12446,23147,119695,19271,174559,0,0,9,1,10,163.9795918367347,93.75510204081634,20.979591836734695
Ireland,2007,41,2007-10-08,12446,23147,119695,19271,174559,1,0,11,1,13,161.93877551020407,105.79591836734694,24.04081632653061
Ireland,2007,42,2007-10-15,12446,23147,119695,19271,174559,2,0,7,0,9,144.28571428571428,85.08163265306122,19.285714285714285
Ireland,2007,43,2007-10-22,12446,23147,119695,19271,174559,0,2,11,0,13,136.81632653061226,73.9795918367347,41.30612244897959
Ireland,2007,44,2007-10-29,12281,22839,118105,19015,172240,0,1,6,1,8,136.97959183673467,86.38775510204081,14.326530612244898
Ireland,2007,45,2007-11-05,12446,23147,119695,19271,174559,1,5,13,0,19,123.67346938775509,74.87755102040818,14.93877551020408
Ireland,2007,46,2007-11-12,13066,24300,125661,20232,183259,1,0,10,1,12,111.36734693877551,59.40816326530613,41.0
Ireland,2007,47,2007-11-19,12707,23632,122205,19675,178219,2,0,7,0,9,98.83673469387755,42.69387755102041,17.69387755102041
Ireland,2007,48,2007-11-26,12282,22842,118118,19017,172259,2,0,18,2,22,113.59183673469387,63.55102040816326,55.265306122448976
Ireland,2007,49,2007-12-03,13066,24300,125661,20232,183259,1,0,13,1,15,118.95918367346938,61.20408163265306,65.57142857142857
Ireland,2007,50,2007-12-10,12753,23717,122644,19746,178860,1,1,13,1,16,96.91836734693878,50.46938775510204,16.918367346938773
Ireland,2007,51,2007-12-17,12597,23427,121146,19505,176675,1,1,15,3,20,84.18367346938774,22.653061224489797,21.18367346938776
Ireland,2007,52,2007-12-24,13066,24300,125661,20232,183259,1,1,25,2,29,101.14285714285714,44.3265306122449,42.10204081632653
Ireland,2008,1,2007-12-31,13066,24300,125661,20232,183259,5,4,77,4,90,73.82539682539684,27.12698412698413,31.952380952380956
Ireland,2008,2,2008-01-07,13066,24300,125661,20232,183259,4,8,65,2,79,85.9795918367347,22.87755102040816,64.61224489795919
Ireland,2008,3,2008-01-14,13066,24300,125661,20232,183259,6,11,67,3,87,101.73469387755104,53.224489795918366,57.77551020408164
Ireland,2008,4,2008-01-21,12689,23598,122029,19647,177963,6,9,41,0,56,110.20408163265306,56.73469387755102,29.081632653061224
Ireland,2008,5,2008-01-28,12426,23109,119499,19240,174274,3,5,42,0,50,83.83673469387756,30.89795918367347,53.87755102040817
Ireland,2008,6,2008-02-04,12957,24096,124605,20062,181720,1,6,27,0,34,107.95918367346938,48.265306122448976,30.244897959183675
Ireland,2008,7,2008-02-11,12924,24035,124289,20011,181259,2,4,25,1,32,95.42857142857143,15.83673469387755,7.285714285714286
Ireland,2008,8,2008-02-18,13458,25028,129425,20838,188749,2,5,33,4,44,101.06122448979592,34.51020408163266,18.53061224489796
Ireland,2008,9,2008-02-25,13956,25954,134213,21609,195732,1,1,33,4,39,106.0,45.0,31.46938775510204
Ireland,2008,10,2008-03-03,14454,26881,139006,22380,202721,0,1,28,3,32,95.38775510204083,36.816326530612244,49.91836734693878
Ireland,2008,11,2008-03-10,14603,27159,140442,22612,204816,2,3,29,2,36,100.85714285714286,41.816326530612244,35.95918367346938
Ireland,2008,12,2008-03-17,14603,27159,140442,22612,204816,2,4,15,0,21,96.53061224489797,27.36734693877551,16.48979591836735
Ireland,2008,13,2008-03-24,14234,26472,136890,22040,199636,2,1,26,1,30,106.18367346938774,37.42857142857143,42.816326530612244
Ireland,2008,14,2008-03-31,14603,27159,140442,22612,204816,0,0,24,0,24,120.36734693877553,54.36734693877552,15.183673469387754
Ireland,2008,15,2008-04-07,14425,26827,138728,22336,202316,0,1,11,1,13,103.10204081632654,26.265306122448976,18.061224489795915
Ireland,2008,16,2008-04-14,14083,26191,135437,21806,197517,0,1,23,0,24,111.53061224489795,43.59183673469388,6.8775510204081645
Ireland,2008,17,2008-04-21,13983,26005,134477,21651,196116,1,1,13,3,18,141.65306122448982,69.93877551020408,24.367346938775512
Ireland,2008,18,2008-04-28,14069,26164,135300,21784,197317,2,1,10,0,13,142.79591836734696,67.73469387755102,27.3265306122449
Ireland,2008,19,2008-05-05,14069,26164,135300,21784,197317,1,0,3,0,4,179.530612244898,98.38775510204083,9.306122448979592
Ireland,2008,20,2008-05-12,14069,26164,135300,21784,197317,0,0,6,0,6,169.61224489795921,86.22448979591836,8.244897959183673
Ireland,2008,21,2008-05-19,13458,25028,129425,20838,188749,0,2,3,0,5,160.46938775510202,89.44897959183673,23.44897959183673
Ireland,2008,22,2008-05-26,14461,26893,139071,22391,202816,0,2,5,0,7,178.0,97.38775510204081,12.26530612244898
Ireland,2008,23,2008-06-02,14290,26575,137425,22126,200416,0,0,3,0,3,175.65306122448982,87.95918367346938,18.938775510204085
Ireland,2008,24,2008-06-09,14394,26770,138433,22288,201885,0,0,4,0,4,171.0408163265306,102.63265306122449,12.122448979591837
Ireland,2008,25,2008-06-16,14204,26416,136602,21993,199215,0,0,2,0,2,166.20408163265307,97.10204081632654,56.06122448979591
Ireland,2008,26,2008-06-23,14603,27159,140442,22612,204816,1,0,5,1,7,174.22448979591837,112.30612244897956,29.918367346938776
Ireland,2008,27,2008-06-30,14603,27159,140442,22612,204816,0,0,1,0,1,178.28571428571425,116.26530612244899,50.265306122448976
Ireland,2008,28,2008-07-07,13534,25170,130157,20956,189817,0,0,5,1,6,174.30612244897958,112.67346938775509,20.938775510204085
Ireland,2008,29,2008-07-14,13669,25422,131460,21165,191716,0,0,2,1,3,182.59183673469389,126.9591836734694,25.040816326530607
Ireland,2008,30,2008-07-21,190732,25291,130785,21057,367865,0,0,0,1,1,205.20408163265304,129.87755102040816,12.530612244897961
Ireland,2008,31,2008-07-28,14069,26164,135300,21784,197317,0,1,2,0,3,198.4081632653061,134.0612244897959,53.775510204081634
Ireland,2008,32,2008-08-04,14069,26164,135300,21784,197317,1,1,1,0,3,187.14285714285717,130.67346938775512,48.59183673469388
Ireland,2008,33,2008-08-11,14074,26175,135355,21793,197397,0,0,1,0,1,176.3265306122449,114.61224489795919,86.26530612244899
Ireland,2008,34,2008-08-18,14436,26847,138831,22352,202466,0,0,2,1,3,181.9387755102041,120.26530612244899,33.08163265306122
Ireland,2008,35,2008-08-25,13870,25795,133393,21477,194535,1,0,4,0,5,185.12244897959184,136.3061224489796,20.571428571428573
Ireland,2008,36,2008-09-01,14176,26363,136328,21949,198816,0,0,7,0,7,165.46938775510202,102.71428571428571,43.10204081632652
Ireland,2008,37,2008-09-08,14324,26639,137754,22179,200896,1,0,4,0,5,170.18367346938774,107.48979591836735,49.20408163265306
Ireland,2008,38,2008-09-15,13598,25290,130777,21056,190721,1,2,8,0,11,167.0408163265306,101.36734693877551,11.428571428571429
Ireland,2008,39,2008-09-22,13757,25584,132299,21301,192941,1,2,7,0,10,165.97959183673467,82.71428571428571,9.959183673469388
Ireland,2008,40,2008-09-29,13041,24252,125414,20192,182899,1,0,4,1,6,139.48979591836732,75.46938775510205,53.48979591836735
Ireland,2008,41,2008-10-06,13012,24199,125140,20148,182499,0,0,7,3,10,151.40816326530611,83.61224489795919,43.122448979591844
Ireland,2008,42,2008-10-13,14606,27164,140470,22616,204856,0,2,10,1,13,139.18367346938774,78.12244897959184,35.755102040816325
Ireland,2008,43,2008-10-20,14863,27641,142938,23014,208456,1,0,10,0,11,129.20408163265307,70.73469387755102,64.71428571428571
Ireland,2008,44,2008-10-27,14889,27690,143192,23054,208825,2,0,11,1,14,91.59183673469389,33.30612244897959,28.040816326530614
Ireland,2008,45,2008-11-03,14581,27117,140228,22577,204503,1,0,10,2,13,107.89795918367346,53.59183673469388,49.55102040816326
Ireland,2008,46,2008-11-10,14610,27171,140504,22622,204907,0,2,15,2,19,115.85714285714286,67.71428571428571,30.224489795918366
Ireland,2008,47,2008-11-17,15050,27989,144736,23303,211078,1,5,14,1,21,109.22448979591836,71.59183673469387,24.530612244897956
Ireland,2008,48,2008-11-24,15023,27940,144481,23262,210706,1,2,17,3,23,81.26530612244899,29.95918367346939,27.244897959183675
Ireland,2008,49,2008-12-01,14639,27225,140786,22667,205317,2,4,32,3,41,78.48979591836735,11.183673469387756,37.55102040816326
Ireland,2008,50,2008-12-08,15125,28128,145455,23419,212127,3,5,69,1,78,78.67346938775509,25.387755102040817,45.87755102040817
Ireland,2008,51,2008-12-15,14843,27604,142746,22983,208176,11,22,88,6,127,107.79591836734694,43.16326530612245,27.77551020408163
Ireland,2008,52,2008-12-22,15024,27942,144491,23264,210721,13,26,109,5,153,82.61224489795919,43.44897959183674,10.551020408163266
Ireland,2009,1,2008-12-29,15080,28045,145029,23350,211504,7,15,175,15,212,62.32142857142857,21.857142857142858,14.571428571428571
Ireland,2009,2,2009-01-05,15258,28377,146743,23626,214004,10,11,218,19,258,74.0204081632653,9.979591836734697,33.795918367346935
Ireland,2009,3,2009-01-12,15258,28377,146743,23626,214004,7,20,166,18,211,90.59183673469387,35.816326530612244,63.53061224489796
Ireland,2009,4,2009-01-19,14884,27681,143146,23046,208757,4,11,67,8,90,72.65306122448979,17.69387755102041,56.30612244897959
Ireland,2009,5,2009-01-26,15258,28377,146743,23626,214004,3,9,52,1,65,87.81632653061226,39.53061224489796,51.12244897959183
Ireland,2009,6,2009-02-02,15258,28377,146743,23626,214004,1,4,30,2,37,53.3265306122449,2.7551020408163276,19.877551020408163
Ireland,2009,7,2009-02-09,15093,28069,145153,23370,211685,1,7,14,0,22,90.30612244897961,27.897959183673468,17.734693877551017
Ireland,2009,8,2009-02-16,15258,28377,146743,23626,214004,1,2,13,1,17,101.79591836734694,45.857142857142854,10.204081632653061
Ireland,2009,9,2009-02-23,15258,28377,146743,23626,214004,1,1,14,0,16,104.55102040816325,55.265306122448976,17.63265306122449
Ireland,2009,10,2009-03-02,14909,27727,143384,23085,209105,0,0,6,1,7,90.97959183673468,25.571428571428573,40.36734693877552
Ireland,2009,11,2009-03-09,15258,28377,146743,23626,214004,0,0,16,0,16,114.89795918367348,54.877551020408156,23.918367346938773
Ireland,2009,12,2009-03-16,15258,28377,146743,23626,214004,0,1,4,0,5,130.73469387755105,45.775510204081634,9.673469387755102
Ireland,2009,13,2009-03-23,15098,28078,145201,23377,211754,0,0,7,0,7,102.89795918367346,44.9795918367347,20.571428571428573
Ireland,2009,14,2009-03-30,15080,28045,145029,23350,211504,1,1,6,0,8,129.42857142857142,51.53061224489796,29.061224489795922
Ireland,2009,15,2009-04-06,14867,27649,142979,23020,208515,0,0,5,0,5,121.0204081632653,49.12244897959183,55.10204081632653
Ireland,2009,16,2009-04-13,15258,28377,146743,23626,214004,0,0,5,0,5,130.26530612244898,65.89795918367346,13.40816326530612
Ireland,2009,17,2009-04-20,14709,27356,141464,22776,206305,0,0,3,1,4,134.26530612244898,71.02040816326532,41.0
Ireland,2009,18,2009-04-27,14795,27515,142286,22908,207504,0,0,4,0,4,135.51020408163268,61.836734693877546,35.0
Ireland,2009,19,2009-05-04,14525,27013,139691,22490,203719,1,0,6,1,8,138.22448979591837,71.12244897959184,36.632653061224495
Ireland,2009,20,2009-05-11,14809,27541,142424,22930,207704,1,1,10,0,12,139.6326530612245,75.10204081632654,32.0
Ireland,2009,21,2009-05-18,15266,28392,146821,23638,214117,0,0,13,2,15,153.28571428571428,82.12244897959184,25.857142857142858
Ireland,2009,22,2009-05-25,15710,29216,151086,24325,220337,0,1,8,0,9,182.71428571428572,99.6734693877551,14.979591836734695
Ireland,2009,23,2009-06-01,16442,30578,158128,25459,230607,0,0,7,2,9,185.44897959183672,94.3061224489796,13.428571428571429
Ireland,2009,24,2009-06-08,16442,30578,158128,25459,230607,0,0,8,0,8,169.9795918367347,88.77551020408164,24.346938775510203
Ireland,2009,25,2009-06-15,16380,30464,157537,25364,229745,1,0,9,1,11,178.08163265306126,105.40816326530613,50.95918367346938
Ireland,2009,26,2009-06-22,16289,30293,156653,25221,228456,0,0,2,1,3,210.14285714285714,134.3673469387755,11.877551020408163
Ireland,2009,27,2009-06-29,16464,30619,158337,25492,230912,1,1,1,1,4,202.10204081632654,136.42857142857142,46.77551020408163
Ireland,2009,28,2009-07-06,16096,29935,154802,24923,225756,0,3,15,2,20,182.53061224489798,119.20408163265304,44.632653061224495
Ireland,2009,29,2009-07-13,16719,31094,160794,25888,234495,2,3,21,4,30,183.57142857142858,115.46938775510203,33.02040816326531
Ireland,2009,30,2009-07-20,16413,30524,157846,25413,230196,3,13,59,7,82,190.0408163265306,119.3265306122449,49.653061224489804
Ireland,2009,31,2009-07-27,16673,31008,160348,25816,233845,5,6,72,5,88,178.44897959183672,114.97959183673471,44.59183673469387
Ireland,2009,32,2009-08-03,16862,31359,162165,26109,236495,4,11,62,3,80,190.85714285714286,125.34693877551021,28.408163265306122
Ireland,2009,33,2009-08-10,15813,29408,152076,24484,221781,7,8,67,5,87,187.28571428571428,132.26530612244898,37.57142857142857
Ireland,2009,34,2009-08-17,16252,30225,156303,25165,227945,5,8,59,3,75,189.48979591836738,124.44897959183673,76.10204081632654
Ireland,2009,35,2009-08-24,16367,30439,157407,25343,229556,4,6,59,2,71,177.51020408163268,106.65306122448978,54.93877551020408
Ireland,2009,36,2009-08-31,16701,31059,160616,25859,234235,3,13,69,3,88,166.0612244897959,110.89795918367348,52.40816326530612
Ireland,2009,37,2009-09-07,16906,31441,162591,26177,237115,5,17,74,6,102,183.81632653061226,90.6734693877551,18.26530612244898
Ireland,2009,38,2009-09-14,16295,30305,156713,25231,228544,9,27,114,5,155,163.8979591836735,89.65306122448979,11.489795918367347
Ireland,2009,39,2009-09-21,16117,29973,154999,24955,226044,8,47,116,4,175,169.18367346938774,110.14285714285714,14.285714285714283
Ireland,2009,40,2009-09-28,16618,30905,159819,25731,233073,21,45,130,7,203,154.0612244897959,104.08163265306122,20.428571428571427
Ireland,2009,41,2009-10-05,16785,31217,161430,25990,235422,13,51,143,6,213,146.0,80.0204081632653,32.510204081632644
Ireland,2009,42,2009-10-12,15963,29687,153522,24717,223889,33,125,177,5,340,146.18367346938777,79.65306122448979,14.979591836734695
Ireland,2009,43,2009-10-19,16785,31217,161430,25990,235422,56,175,241,2,474,140.61224489795921,88.42857142857143,58.73469387755102
Ireland,2009,44,2009-10-26,16785,31217,161430,25990,235422,65,113,237,9,424,145.14285714285714,100.53061224489797,71.53061224489797
Ireland,2009,45,2009-11-02,16785,31217,161430,25990,235422,41,67,265,4,377,113.69387755102039,60.02040816326531,49.51020408163265
Ireland,2009,46,2009-11-09,16785,31217,161430,25990,235422,65,72,159,10,306,109.42857142857142,44.40816326530613,71.38775510204081
Ireland,2009,47,2009-11-16,16785,31217,161430,25990,235422,47,70,163,6,287,116.16326530612244,60.204081632653065,87.40816326530613
Ireland,2009,48,2009-11-23,16785,31217,161430,25990,235422,36,42,127,7,212,94.22448979591836,41.44897959183674,41.714285714285715
Ireland,2009,49,2009-11-30,16676,31013,160375,25821,233885,20,21,93,5,139,93.3061224489796,32.36734693877551,44.10204081632653
Ireland,2009,50,2009-12-07,16785,31217,161430,25990,235422,19,18,73,8,118,93.91836734693878,40.51020408163266,29.061224489795915
Ireland,2009,51,2009-12-14,16785,31217,161430,25990,235422,19,10,64,2,95,70.81632653061224,14.224489795918368,21.02040816326531
Ireland,2009,52,2009-12-21,16580,30835,159456,25672,232543,8,7,20,0,35,59.55102040816327,-1.3061224489795917,26.326530612244902
Ireland,2009,53,2009-12-28,16785,31217,161430,25990,235422,1,7,27,1,36,55.892857142857146,13.642857142857142,47.67857142857143
Ireland,2010,1,2010-01-04,16785,31217,161430,25990,235422,2,1,43,3,49,43.55102040816326,-17.163265306122447,19.51020408163265
Ireland,2010,2,2010-01-11,16785,31217,161430,25990,235422,3,3,28,5,39,76.67346938775509,19.489795918367346,58.6530612244898
Ireland,2010,3,2010-01-18,16643,30952,160059,25770,233424,1,1,20,7,29,82.77551020408161,26.265306122448976,29.63265306122449
Ireland,2010,4,2010-01-25,16785,31217,161430,25990,235422,0,1,14,1,16,74.71428571428571,17.489795918367346,21.224489795918366
Ireland,2010,5,2010-02-01,16785,31217,161430,25990,235422,1,2,11,1,15,85.97959183673468,24.285714285714285,33.897959183673464
Ireland,2010,6,2010-02-08,16785,31217,161430,25990,235422,0,4,10,1,15,71.18367346938774,7.040816326530612,15.408163265306124
Ireland,2010,7,2010-02-15,16785,31217,161430,25990,235422,2,0,11,0,13,68.06122448979592,2.326530612244897,14.959183673469386
Ireland,2010,8,2010-02-22,16240,30202,156185,25146,227773,0,1,15,0,16,71.81632653061224,7.612244897959185,26.061224489795915
Ireland,2010,9,2010-03-01,16785,31217,161430,25990,235422,2,2,14,2,20,87.65306122448979,4.6938775510204085,17.73469387755102
Ireland,2010,10,2010-03-08,16542,30763,159086,25613,232004,2,0,8,4,14,96.10204081632654,12.469387755102039,9.959183673469386
Ireland,2010,11,2010-03-15,16636,30939,159994,25759,233328,1,3,13,2,19,113.51020408163266,47.163265306122454,23.979591836734695
Ireland,2010,12,2010-03-22,16037,29825,154231,24831,224924,2,0,12,1,15,111.6938775510204,50.22448979591836,31.46938775510204
Ireland,2010,13,2010-03-29,16495,30678,158642,25541,231356,0,1,6,2,9,94.67346938775509,26.95918367346939,49.69387755102041
Ireland,2010,14,2010-04-05,16785,31217,161430,25990,235422,0,0,4,1,5,135.5918367346939,52.83673469387755,24.30612244897959
Ireland,2010,15,2010-04-12,15808,29400,152036,24478,221722,1,0,5,0,6,133.0204081632653,43.3061224489796,13.10204081632653
Ireland,2010,16,2010-04-19,16785,31217,161430,25990,235422,0,0,12,0,12,132.6122448979592,48.265306122448976,16.73469387755102
Ireland,2010,17,2010-04-26,16785,31217,161430,25990,235422,0,0,8,2,10,140.26530612244898,80.79591836734694,23.53061224489796
Ireland,2010,18,2010-05-03,16472,30633,158413,25505,231023,0,0,3,0,3,136.55102040816325,59.69387755102042,15.22448979591837
Ireland,2010,19,2010-05-10,16785,31217,161430,25990,235422,0,1,9,1,11,132.0612244897959,53.714285714285715,16.755102040816325
Ireland,2010,20,2010-05-17,15888,29548,152802,24601,222839,0,0,8,0,8,182.57142857142858,91.59183673469387,20.53061224489796
Ireland,2010,21,2010-05-24,16770,31188,161282,25966,235206,0,2,6,0,8,156.59183673469389,75.24489795918369,17.877551020408163
Ireland,2010,22,2010-05-31,16876,31386,162303,26131,236696,0,0,3,0,4,179.75510204081635,98.61224489795919,22.653061224489793
Ireland,2010,23,2010-06-07,17040,31691,163880,26385,238996,0,0,3,0,3,168.71428571428572,100.24489795918369,23.081632653061227
Ireland,2010,24,2010-06-14,17040,31691,163880,26385,238996,0,0,2,0,2,183.3061224489796,97.14285714285714,12.714285714285714
Ireland,2010,25,2010-06-21,16897,31425,162508,26164,236994,1,0,2,0,3,193.20408163265304,111.81632653061224,14.612244897959183
Ireland,2010,26,2010-06-28,16776,31200,161343,25976,235295,2,1,4,1,8,191.34693877551018,119.81632653061226,29.489795918367346
Ireland,2010,27,2010-07-05,16683,31028,160451,25833,233995,0,0,2,0,2,183.22448979591837,115.28571428571429,39.693877551020414
Ireland,2010,28,2010-07-12,16420,30537,157914,25424,230295,0,0,0,1,1,185.08163265306123,119.48979591836735,36.326530612244895
Ireland,2010,29,2010-07-19,17040,31691,163880,26385,238996,0,0,2,1,3,185.89795918367346,120.85714285714285,32.59183673469388
Ireland,2010,30,2010-07-26,17040,31691,163880,26385,238996,0,0,2,0,2,187.22448979591837,127.10204081632651,33.77551020408164
Ireland,2010,31,2010-08-02,16862,31359,162165,26109,236495,0,0,5,0,5,183.63265306122452,119.04081632653062,23.85714285714286
Ireland,2010,32,2010-08-09,16241,30205,156200,25148,227794,0,0,3,0,3,183.44897959183672,116.38775510204081,20.877551020408163
Ireland,2010,33,2010-08-16,17040,31691,163880,26385,238996,0,0,6,0,6,185.87755102040816,118.18367346938776,30.26530612244898
Ireland,2010,34,2010-08-23,17040,31691,163880,26385,238996,0,0,5,1,6,178.89795918367346,103.95918367346938,19.3265306122449
Ireland,2010,35,2010-08-30,16270,30258,156474,25192,228194,1,0,5,1,7,191.85714285714286,108.61224489795919,34.57142857142857
Ireland,2010,36,2010-09-06,16593,30859,159578,25692,232722,1,1,7,2,11,175.71428571428575,116.97959183673468,45.612244897959194
Ireland,2010,37,2010-09-13,16977,31574,163276,26288,238115,1,0,7,0,8,165.89795918367346,104.0,29.102040816326532
Ireland,2010,38,2010-09-20,17040,31691,163880,26385,238996,0,1,22,3,26,160.3673469387755,102.44897959183675,27.55102040816326
Ireland,2010,39,2010-09-27,16763,31175,161213,25955,235106,1,1,14,1,17,156.48979591836738,87.59183673469387,33.87755102040816
Ireland,2010,40,2010-10-04,18573,34541,178621,28758,260493,1,0,18,1,20,158.48979591836738,97.51020408163265,25.24489795918367
Ireland,2010,41,2010-10-11,18768,34904,180500,29061,263233,1,2,12,2,17,142.0408163265306,66.3265306122449,17.95918367346939
Ireland,2010,42,2010-10-18,18522,34447,178136,28680,259785,1,1,10,3,15,125.34693877551022,65.20408163265306,31.51020408163265
Ireland,2010,43,2010-10-25,18768,34904,180500,29061,263233,1,1,10,2,14,127.7142857142857,66.93877551020408,49.51020408163266
Ireland,2010,44,2010-11-01,17786,33079,171058,27541,249464,0,0,14,3,17,117.0408163265306,63.89795918367347,50.285714285714285
Ireland,2010,45,2010-11-08,18497,34399,177887,28640,259423,0,0,18,2,20,100.59183673469389,45.06122448979592,43.16326530612245
Ireland,2010,46,2010-11-15,18768,34904,180500,29061,263233,0,4,22,1,27,96.6326530612245,44.10204081632652,38.6530612244898
Ireland,2010,47,2010-11-22,18768,34904,180500,29061,263233,0,1,14,3,18,73.79591836734694,21.163265306122447,25.44897959183674
Ireland,2010,48,2010-11-29,17784,33074,171035,27537,249430,1,4,11,0,16,59.53061224489796,1.7142857142857137,25.918367346938776
Ireland,2010,49,2010-12-06,18098,33657,174051,28022,253828,0,4,29,3,36,73.18367346938774,18.714285714285715,25.510204081632654
Ireland,2010,50,2010-12-13,18599,34590,178871,28798,260858,5,6,48,1,60,65.32653061224491,17.816326530612244,26.26530612244898
Ireland,2010,51,2010-12-20,17741,32993,170617,27469,248820,12,22,111,3,148,40.44897959183673,-21.89795918367347,27.081632653061224
Ireland,2010,52,2010-12-27,18533,34467,178237,28696,259933,22,28,237,11,298,92.0857142857143,50.97142857142858,37.97142857142857
Ireland,2011,1,2011-01-03,18768,34904,180500,29061,263233,27,44,442,19,532,64.61224489795919,13.081632653061224,32.06122448979592
Ireland,2011,2,2011-01-10,18597,34586,178851,28795,260829,36,52,354,19,461,90.91836734693877,47.61224489795918,49.244897959183675
Ireland,2011,3,2011-01-17,18768,34904,180500,29061,263233,27,66,181,7,281,72.75510204081634,10.326530612244898,18.938775510204078
Ireland,2011,4,2011-01-24,17988,33453,172993,27852,252286,26,85,121,3,235,74.73469387755101,23.387755102040817,25.306122448979586
Ireland,2011,5,2011-01-31,18768,34904,180500,29061,263233,25,77,99,3,204,93.0,38.816326530612244,59.28571428571429
Ireland,2011,6,2011-02-07,18705,34788,179896,28963,262352,12,32,70,6,120,85.73469387755104,30.489795918367346,36.73469387755102
Ireland,2011,7,2011-02-14,18768,34904,180500,29061,263233,9,22,63,2,96,85.81632653061224,27.020408163265305,26.877551020408163
Ireland,2011,8,2011-02-21,18412,34241,177071,28509,258233,9,9,41,5,64,99.24489795918369,47.04081632653061,24.26530612244898
Ireland,2011,9,2011-02-28,18353,34132,176503,28417,257405,2,4,41,3,50,94.51020408163265,23.83673469387755,14.612244897959183
Ireland,2011,10,2011-03-07,18768,34904,180500,29061,263233,3,4,27,1,35,93.89795918367346,33.97959183673469,30.775510204081627
Ireland,2011,11,2011-03-14,17462,32476,167940,27039,244917,1,1,10,2,14,100.89795918367348,30.061224489795915,18.3265306122449
Ireland,2011,12,2011-03-21,17387,32336,167218,26922,243863,0,4,16,2,22,117.36734693877551,37.06122448979592,13.36734693877551
Ireland,2011,13,2011-03-28,18768,34904,180500,29061,263233,0,1,19,2,22,118.75510204081634,51.04081632653061,32.142857142857146
Ireland,2011,14,2011-04-04,17985,33447,172964,27847,252243,2,1,8,2,13,134.0408163265306,61.14285714285713,23.3265306122449
Ireland,2011,15,2011-04-11,18358,34142,176557,28426,257483,1,1,6,1,9,125.79591836734694,53.653061224489804,20.571428571428573
Ireland,2011,16,2011-04-18,18241,33923,175426,28244,255834,1,0,5,1,7,142.9387755102041,61.06122448979592,12.959183673469388
Ireland,2011,17,2011-04-25,17724,32962,170455,27443,248584,0,0,11,0,11,145.77551020408163,61.91836734693878,14.448979591836734
Ireland,2011,18,2011-05-02,18604,34599,178921,28806,260930,0,0,5,1,6,146.32653061224488,76.22448979591836,41.30612244897959
Ireland,2011,19,2011-05-09,18562,34521,178517,28741,260341,1,0,5,0,6,144.24489795918365,76.28571428571426,26.571428571428573
Ireland,2011,20,2011-05-16,17944,33372,172576,27785,251677,1,2,9,2,14,146.24489795918367,78.57142857142857,31.204081632653065
Ireland,2011,21,2011-05-23,18614,34617,179013,28821,261065,0,0,7,0,7,149.26530612244898,83.24489795918369,22.448979591836736
Ireland,2011,22,2011-05-30,18497,34401,177894,28641,259433,0,0,7,0,7,166.77551020408166,89.85714285714286,18.061224489795922
Ireland,2011,23,2011-06-06,18098,33657,174051,28022,253828,0,0,5,1,6,156.87755102040816,81.04081632653062,34.44897959183673
Ireland,2011,24,2011-06-13,18528,34457,178187,28688,259860,1,0,12,0,13,168.89795918367346,94.42857142857143,27.979591836734695
Ireland,2011,25,2011-06-20,18768,34904,180500,29061,263233,0,0,2,1,3,171.0408163265306,104.57142857142857,30.428571428571427
Ireland,2011,26,2011-06-27,18768,34904,180500,29061,263233,0,0,2,0,2,177.04081632653063,101.34693877551021,15.10204081632653
Ireland,2011,27,2011-07-04,18768,34904,180500,29061,263233,1,0,4,0,5,180.6734693877551,112.71428571428571,38.693877551020414
Ireland,2011,28,2011-07-11,18098,33657,174051,28022,253828,1,0,3,0,4,183.28571428571428,113.6938775510204,21.97959183673469
Ireland,2011,29,2011-07-18,18098,33657,174051,28022,253828,0,1,4,1,6,179.53061224489792,114.38775510204081,18.591836734693878
Ireland,2011,30,2011-07-25,18590,34573,178785,28785,260733,1,0,6,1,8,185.6734693877551,118.6530612244898,18.81632653061224
Ireland,2011,31,2011-08-01,17590,32713,169169,27236,246708,0,0,2,2,4,182.26530612244898,115.28571428571426,25.795918367346935
Ireland,2011,32,2011-08-08,18098,33657,174051,28022,253828,0,0,1,0,1,182.3469387755102,120.83673469387756,31.122448979591837
Ireland,2011,33,2011-08-15,18098,33657,174051,28022,253828,0,0,2,0,2,181.77551020408166,108.9795918367347,26.387755102040817
Ireland,2011,34,2011-08-22,18098,33657,174051,28022,253828,0,0,1,1,2,177.42857142857142,104.89795918367348,28.938775510204085
Ireland,2011,35,2011-08-29,17992,33460,173032,27858,252342,0,0,6,0,6,173.51020408163268,106.42857142857143,32.89795918367347
Ireland,2011,36,2011-09-05,17990,33457,173016,27856,252319,1,1,2,0,4,170.46938775510202,113.24489795918366,46.97959183673469
Ireland,2011,37,2011-09-12,18164,33781,174688,28125,254758,0,0,8,0,8,160.22448979591834,101.75510204081634,36.04081632653062
Ireland,2011,38,2011-09-19,18468,34347,177616,28596,259027,0,0,2,0,2,161.51020408163268,100.85714285714286,26.571428571428573
Ireland,2011,39,2011-09-26,14648,27242,140877,22681,205448,1,0,9,0,10,169.34693877551018,107.85714285714286,37.3469387755102
Ireland,2011,40,2011-10-03,18638,34662,179245,28859,261404,0,0,7,2,9,149.22448979591837,95.83673469387757,37.816326530612244
Ireland,2011,41,2011-10-10,18638,34662,179245,28859,261404,1,1,14,2,18,147.18367346938777,98.08163265306122,40.89795918367347
Ireland,2011,42,2011-10-17,16959,31539,163099,26259,237856,0,3,13,1,17,128.02040816326527,74.53061224489797,62.40816326530613
Ireland,2011,43,2011-10-24,18504,34413,177956,28651,259524,0,1,8,1,10,129.48979591836735,76.18367346938774,39.204081632653065
Ireland,2011,44,2011-10-31,18638,34662,179245,28859,261404,1,0,10,1,12,126.06122448979592,69.38775510204083,39.85714285714287
Ireland,2011,45,2011-11-07,18638,34662,179245,28859,261404,0,1,16,3,20,124.0408163265306,67.91836734693878,24.591836734693878
Ireland,2011,46,2011-11-14,18575,34545,178641,28761,260522,0,0,17,4,21,117.75510204081631,71.20408163265306,45.77551020408163
Ireland,2011,47,2011-11-21,18509,34423,178011,28660,259603,2,0,12,2,16,105.95918367346938,58.20408163265306,42.673469387755105
Ireland,2011,48,2011-11-28,18638,34662,179245,28859,261404,0,3,16,2,21,95.61224489795917,47.87755102040817,64.73469387755102
Ireland,2011,49,2011-12-05,17656,32836,169804,27339,247635,1,4,16,1,22,83.18367346938776,36.10204081632653,42.24489795918367
Ireland,2011,50,2011-12-12,18638,34662,179245,28859,261404,0,2,28,1,31,77.28571428571429,26.551020408163264,51.775510204081634
Ireland,2011,51,2011-12-19,18638,34662,179245,28859,261404,1,5,24,1,31,98.26530612244899,52.673469387755105,33.79591836734694
Ireland,2011,52,2011-12-26,18459,34330,177531,28583,258903,2,0,15,1,18,89.0,50.339285714285715,42.142857142857146
Ireland,2012,1,2012-01-02,18638,34662,179245,28859,261404,6,3,24,2,35,86.94642857142857,45.44642857142857,36.125
Ireland,2012,2,2012-01-09,18638,34662,179245,28859,261404,3,9,24,4,40,86.36734693877551,48.204081632653065,24.02040816326531
Ireland,2012,3,2012-01-16,18638,34662,179245,28859,261404,1,5,21,1,28,88.3061224489796,47.6530612244898,30.408163265306122
Ireland,2012,4,2012-01-23,18337,34102,176351,28393,257183,5,4,19,1,29,85.85714285714286,38.51020408163265,50.204081632653065
Ireland,2012,5,2012-01-30,17967,33415,172796,27820,251998,5,2,26,6,39,74.24489795918369,26.428571428571423,25.428571428571434
Ireland,2012,6,2012-02-06,17967,33415,172796,27820,251998,12,9,36,7,64,92.02040816326532,46.836734693877546,30.46938775510204
Ireland,2012,7,2012-02-13,17789,33083,171082,27544,249498,4,17,62,7,90,88.67346938775509,44.877551020408156,18.816326530612248
Ireland,2012,8,2012-02-20,18638,34662,179245,28859,261404,6,16,76,10,108,103.87755102040816,55.0,22.102040816326532
Ireland,2012,9,2012-02-27,18392,34205,176881,28478,257956,13,14,54,4,85,102.91836734693878,51.06122448979592,16.346938775510203
Ireland,2012,10,2012-03-05,18411,34241,177066,28508,258226,7,10,39,3,59,104.14285714285714,49.69387755102041,20.71428571428572
Ireland,2012,11,2012-03-12,18638,34662,179245,28859,261404,6,3,31,1,41,104.20408163265306,48.775510204081634,18.46938775510204
Ireland,2012,12,2012-03-19,18638,34662,179245,28859,261404,3,3,21,3,30,126.85714285714288,56.775510204081634,11.224489795918368
Ireland,2012,13,2012-03-26,17675,32872,169991,27369,247907,1,2,17,0,20,132.77551020408166,47.79591836734695,10.102040816326532
Ireland,2012,14,2012-04-02,18281,33999,175816,28307,256403,0,1,10,3,14,107.51020408163264,46.244897959183675,19.3265306122449
Ireland,2012,15,2012-04-09,16510,30706,158786,25565,231567,1,2,22,1,26,112.36734693877551,38.59183673469388,20.36734693877551
Ireland,2012,16,2012-04-16,18638,34662,179245,28859,261404,0,1,13,3,17,119.24489795918366,47.122448979591844,33.224489795918366
Ireland,2012,17,2012-04-23,18238,33919,175405,28240,255802,0,0,10,0,10,119.12244897959182,45.06122448979592,19.367346938775512
Ireland,2012,18,2012-04-30,18638,34662,179245,28859,261404,0,0,12,1,13,132.3061224489796,58.12244897959183,13.816326530612244
Ireland,2012,19,2012-05-07,17405,32369,167391,26950,244115,0,0,7,0,7,129.28571428571428,58.00000000000001,31.551020408163264
Ireland,2012,20,2012-05-14,17879,33251,171947,27684,250761,1,1,11,0,13,133.75510204081633,65.16326530612244,17.979591836734695
Ireland,2012,21,2012-05-21,18156,33766,174612,28113,254647,0,1,8,1,10,186.9795918367347,97.26530612244896,11.653061224489798
Ireland,2012,22,2012-05-28,18431,34278,177262,28539,258510,0,0,1,0,1,169.6326530612245,101.30612244897961,26.346938775510207
Ireland,2012,23,2012-06-04,18043,33556,173526,27938,253063,0,0,1,0,1,159.63265306122452,91.51020408163265,42.93877551020408
Ireland,2012,24,2012-06-11,17572,32680,168998,27209,246459,0,0,5,0,5,160.87755102040816,97.40816326530613,26.693877551020414
Ireland,2012,25,2012-06-18,17356,32279,166923,26875,243433,0,0,5,0,5,165.48979591836738,97.14285714285715,41.04081632653061
Ireland,2012,26,2012-06-25,18238,33919,175405,28240,255802,0,0,3,1,4,179.0,112.77551020408161,41.79591836734694
Ireland,2012,27,2012-07-02,18356,34139,176540,28423,257458,1,0,8,0,9,182.16326530612247,118.16326530612245,29.591836734693878
Ireland,2012,28,2012-07-09,18126,33710,174324,28066,254226,0,0,4,0,4,173.18367346938777,105.7142857142857,29.428571428571423
Ireland,2012,29,2012-07-16,18212,33870,175151,28200,255433,0,0,4,0,4,183.9795918367347,115.85714285714286,24.612244897959183
Ireland,2012,30,2012-07-23,18157,33767,174618,28114,254656,0,1,2,1,4,181.77551020408166,118.53061224489797,28.285714285714285
Ireland,2012,31,2012-07-30,18264,33966,175647,28279,256156,0,0,4,1,5,183.71428571428572,118.44897959183673,39.0
Ireland,2012,32,2012-08-06,18638,34662,179245,28859,261404,1,0,3,0,4,194.48979591836732,122.93877551020408,25.142857142857142
Ireland,2012,33,2012-08-13,18484,34377,177771,28621,259253,0,0,3,1,4,197.36734693877548,130.53061224489795,37.48979591836735
Ireland,2012,34,2012-08-20,17798,33100,171167,27558,249623,0,0,2,0,2,183.57142857142858,119.38775510204081,39.46938775510204
Ireland,2012,35,2012-08-27,18638,34662,179245,28859,261404,0,0,2,0,2,180.83673469387756,117.04081632653062,22.102040816326532
Ireland,2012,36,2012-09-03,18638,34662,179245,28859,261404,1,1,9,1,12,181.67346938775512,111.20408163265304,21.04081632653061
Ireland,2012,37,2012-09-10,17818,33137,171359,27589,249903,0,0,8,0,8,161.57142857142858,104.04081632653062,33.775510204081634
Ireland,2012,38,2012-09-17,17262,32104,166016,26729,242111,0,0,7,0,7,155.0,84.51020408163265,32.816326530612244
Ireland,2012,39,2012-09-24,16016,29786,154034,24800,224636,0,2,11,3,16,148.83673469387756,93.85714285714286,36.08163265306123
Ireland,2012,40,2012-10-01,20301,35508,175092,30502,261403,1,1,14,1,17,141.40816326530611,76.06122448979592,39.51020408163265
Ireland,2012,41,2012-10-08,20301,35508,175092,30502,261403,0,0,10,1,11,136.18367346938777,73.57142857142857,36.204081632653065
Ireland,2012,42,2012-10-15,20301,35508,175092,30502,261403,0,0,19,2,21,130.32653061224488,75.0204081632653,40.326530612244895
Ireland,2012,43,2012-10-22,20116,35186,173501,30225,259028,0,2,14,1,17,119.30612244897961,69.20408163265306,27.387755102040817
Ireland,2012,44,2012-10-29,20301,35508,175092,30502,261403,1,0,10,0,11,102.79591836734691,48.44897959183674,42.77551020408163
Ireland,2012,45,2012-11-05,20075,35114,173149,30164,258502,0,0,11,0,11,107.77551020408164,56.06122448979591,34.367346938775505
Ireland,2012,46,2012-11-12,20301,35508,175092,30502,261403,1,2,7,0,10,103.93877551020408,53.53061224489796,53.244897959183675
Ireland,2012,47,2012-11-19,20301,35508,175092,30502,261403,0,2,18,0,20,91.89795918367346,43.775510204081634,35.183673469387756
Ireland,2012,48,2012-11-26,20301,35508,175092,30502,261403,1,1,13,1,16,82.32653061224491,30.489795918367353,27.3265306122449
Ireland,2012,49,2012-12-03,20301,35508,175092,30502,261403,3,9,16,2,30,85.12244897959184,35.06122448979592,33.75510204081633
Ireland,2012,50,2012-12-10,19727,34506,170147,29641,254021,5,14,36,2,57,78.6530612244898,33.02040816326531,36.775510204081634
Ireland,2012,51,2012-12-17,18933,33117,163299,28448,243797,7,31,38,5,81,89.75510204081631,45.204081632653065,37.93877551020408
Ireland,2012,52,2012-12-24,20181,35299,174061,30323,259864,8,19,59,1,87,87.51785714285714,41.875,45.44642857142857
Ireland,2013,1,2012-12-31,20301,35508,175092,30502,261403,8,17,124,7,156,102.35714285714286,55.642857142857146,40.25
Ireland,2013,2,2013-01-07,20301,35508,175092,30502,261403,5,18,91,12,126,85.34693877551021,32.3469387755102,28.816326530612248
Ireland,2013,3,2013-01-14,20301,35508,175092,30502,261403,4,14,99,4,121,62.89795918367347,24.795918367346935,47.755102040816325
Ireland,2013,4,2013-01-21,19175,33539,165381,28811,246906,3,30,73,6,112,67.0,12.714285714285714,48.163265306122454
Ireland,2013,5,2013-01-28,19384,33905,167188,29125,249602,5,34,105,4,148,98.61224489795919,36.87755102040817,39.326530612244895
Ireland,2013,6,2013-02-04,19726,34503,170135,29639,254003,4,25,113,9,151,83.85714285714286,35.48979591836734,47.38775510204082
Ireland,2013,7,2013-02-11,19283,33729,166316,28973,248301,4,15,72,5,96,93.04081632653062,42.93877551020408,28.122448979591837
Ireland,2013,8,2013-02-18,19657,34384,169546,29536,253123,6,9,66,4,85,69.71428571428571,21.77551020408163,3.8571428571428568
Ireland,2013,9,2013-02-25,18920,33094,163189,28429,243632,2,19,77,4,102,82.0,11.081632653061224,4.551020408163265
Ireland,2013,10,2013-03-04,18477,32319,159365,27763,237924,5,8,55,6,74,88.32653061224491,47.51020408163265,24.653061224489793
Ireland,2013,11,2013-03-11,20301,35508,175092,30502,261403,1,4,47,6,58,76.57142857142857,2.6326530612244903,21.28571428571429
Ireland,2013,12,2013-03-18,20301,35508,175092,30502,261403,1,6,35,6,48,68.48979591836736,24.979591836734695,44.51020408163266
Ireland,2013,13,2013-03-25,20301,35508,175092,30502,261403,1,6,46,6,59,61.02040816326531,9.122448979591834,6.530612244897959
Ireland,2013,14,2013-04-01,19626,34328,169271,29488,252713,2,6,32,2,42,87.06122448979592,9.448979591836734,4.408163265306123
Ireland,2013,15,2013-04-08,20301,35508,175092,30502,261403,2,6,32,6,46,108.9591836734694,42.612244897959194,29.346938775510207
Ireland,2013,16,2013-04-15,20301,35508,175092,30502,261403,1,3,21,4,29,130.55102040816328,62.51020408163265,42.326530612244895
Ireland,2013,17,2013-04-22,20145,35237,173752,30269,259403,2,3,13,3,21,126.16326530612244,62.40816326530613,21.448979591836736
Ireland,2013,18,2013-04-29,20301,35508,175092,30502,261403,0,0,11,2,13,135.67346938775512,59.122448979591844,16.816326530612244
Ireland,2013,19,2013-05-06,19571,34231,168796,29405,252003,0,0,6,3,9,138.77551020408163,78.3265306122449,37.122448979591844
Ireland,2013,20,2013-05-13,19481,34075,168025,29271,250852,0,0,2,0,2,127.3469387755102,58.46938775510204,27.18367346938776
Ireland,2013,21,2013-05-20,19518,34139,168340,29326,251323,0,1,3,1,5,141.57142857142858,77.36734693877551,17.3265306122449
Ireland,2013,22,2013-05-27,20301,35508,175092,30502,261403,0,0,2,0,2,156.10204081632654,79.38775510204081,12.489795918367347
Ireland,2013,23,2013-06-03,20301,35508,175092,30502,261403,0,1,0,0,1,200.18367346938774,88.63265306122449,3.2857142857142856
Ireland,2013,24,2013-06-10,20301,35508,175092,30502,261403,0,0,0,3,3,165.67346938775512,98.75510204081631,69.79591836734694
Ireland,2013,25,2013-06-17,20301,35508,175092,30502,261403,0,0,2,0,2,174.14285714285717,108.7142857142857,17.79591836734694
Ireland,2013,26,2013-06-24,20301,35508,175092,30502,261403,0,0,2,0,2,173.77551020408166,106.26530612244899,10.857142857142858
Ireland,2013,27,2013-07-01,20301,35508,175092,30502,261403,0,0,3,0,3,189.00000000000003,116.18367346938774,17.632653061224488
Ireland,2013,28,2013-07-08,20301,35508,175092,30502,261403,1,0,0,0,1,231.75510204081633,128.81632653061223,3.877551020408163
Ireland,2013,29,2013-07-15,20301,35508,175092,30502,261403,0,0,3,0,3,229.87755102040816,138.85714285714286,4.204081632653062
Ireland,2013,30,2013-07-22,20301,35508,175092,30502,261403,0,0,2,0,2,210.9183673469388,140.85714285714286,41.285714285714285
Ireland,2013,31,2013-07-29,20083,35128,173215,30175,258601,0,0,1,0,1,199.6530612244898,130.4285714285714,58.0204081632653
Ireland,2013,32,2013-08-05,19669,34403,169642,29553,253267,0,0,2,0,2,189.9387755102041,122.51020408163266,15.979591836734693
Ireland,2013,33,2013-08-12,18824,32926,162361,28284,242395,0,0,5,2,7,191.5102040816327,129.24489795918367,33.285714285714285
Ireland,2013,34,2013-08-19,20181,35299,174061,30323,259864,0,0,1,0,1,187.30612244897958,126.71428571428574,15.673469387755102
Ireland,2013,35,2013-08-26,19231,33638,165869,28896,247634,0,0,0,1,1,184.0816326530612,119.59183673469387,8.673469387755102
Ireland,2013,36,2013-09-02,18288,31988,157734,27478,235488,0,0,4,0,4,175.0612244897959,101.30612244897961,21.326530612244902
Ireland,2013,37,2013-09-09,18066,31600,155819,27145,232630,0,0,10,2,12,166.3265306122449,102.73469387755104,23.714285714285715
Ireland,2013,38,2013-09-16,17771,31084,153273,26701,228829,0,0,7,4,11,168.10204081632654,100.42857142857143,21.285714285714285
Ireland,2013,39,2013-09-23,16640,29106,143523,25003,214272,0,0,11,4,15,180.40816326530611,127.6530612244898,10.265306122448978
Ireland,2013,40,2013-09-30,19404,33940,167360,29155,249859,0,1,5,2,8,173.42857142857142,126.24489795918369,43.93877551020408
Ireland,2013,41,2013-10-07,19935,34869,171942,29953,256699,0,1,14,3,18,143.0,89.36734693877551,8.081632653061225
Ireland,2013,42,2013-10-14,20148,35242,173777,30273,259440,0,0,7,3,10,150.44897959183677,90.40816326530613,55.93877551020409
Ireland,2013,43,2013-10-21,18900,33059,163015,28398,243372,1,0,6,0,7,145.22448979591837,89.73469387755104,68.71428571428571
Ireland,2013,44,2013-10-28,20148,35242,173777,30273,259440,0,1,2,0,3,118.20408163265306,61.46938775510205,36.612244897959194
Ireland,2013,45,2013-11-04,20148,35242,173777,30273,259440,1,2,11,0,14,103.46938775510205,39.6530612244898,55.02040816326531
Ireland,2013,46,2013-11-11,19405,33942,167368,29157,249872,1,0,11,3,15,112.81632653061226,61.57142857142857,19.836734693877553
Ireland,2013,47,2013-11-18,19871,34756,171384,29856,255867,0,1,9,0,10,80.77551020408164,27.183673469387752,15.755102040816327
Ireland,2013,48,2013-11-25,19124,33451,164948,28735,246258,1,2,17,1,21,94.67346938775509,51.55102040816326,8.673469387755102
Ireland,2013,49,2013-12-02,20148,35242,173777,30273,259440,1,1,15,1,18,101.22448979591839,50.06122448979592,18.69387755102041
Ireland,2013,50,2013-12-09,20148,35242,173777,30273,259440,0,5,21,2,28,119.34693877551022,77.12244897959184,42.61224489795918
Ireland,2013,51,2013-12-16,20148,35242,173777,30273,259440,1,3,12,1,17,89.06122448979592,33.87755102040816,76.40816326530613
Ireland,2013,52,2013-12-23,20148,35242,173777,30273,259440,2,2,12,3,19,83.93877551020408,22.897959183673468,77.08163265306122
Ireland,2014,1,2013-12-30,20148,35242,173777,30273,259440,1,0,29,3,33,89.60714285714286,28.053571428571427,44.517857142857146
Ireland,2014,2,2014-01-06,20148,35242,173777,30273,259440,0,1,30,1,32,88.06122448979592,36.795918367346935,41.775510204081634
Ireland,2014,3,2014-01-13,20148,35242,173777,30273,259440,1,0,26,6,33,81.16326530612245,27.6734693877551,33.28571428571429
Ireland,2014,4,2014-01-20,20148,35242,173777,30273,259440,4,3,38,0,45,93.6938775510204,42.857142857142854,66.75510204081633
Ireland,2014,5,2014-01-27,20148,35242,173777,30273,259440,0,2,50,2,54,80.0204081632653,32.95918367346939,63.20408163265306
Ireland,2014,6,2014-02-03,20148,35242,173777,30273,259440,2,10,66,6,84,82.6734693877551,32.3469387755102,59.08163265306122
Ireland,2014,7,2014-02-10,19919,34841,171801,29929,256490,3,15,91,14,123,76.28571428571429,17.836734693877553,70.10204081632652
Ireland,2014,8,2014-02-17,20148,35242,173777,30273,259440,9,11,103,7,130,97.77551020408166,44.3469387755102,44.55102040816326
Ireland,2014,9,2014-02-24,19964,34919,172186,29996,257065,6,25,101,7,139,91.30612244897961,36.775510204081634,51.38775510204082
Ireland,2014,10,2014-03-03,20148,35242,173777,30273,259440,10,16,89,11,126,103.3061224489796,42.89795918367347,35.224489795918366
Ireland,2014,11,2014-03-10,19418,33965,167481,29176,250040,11,11,75,13,110,108.38775510204083,36.83673469387755,4.2857142857142865
Ireland,2014,12,2014-03-17,20148,35242,173777,30273,259440,5,5,41,6,57,106.08163265306123,53.285714285714285,35.714285714285715
Ireland,2014,13,2014-03-24,20148,35242,173777,30273,259440,10,8,42,7,67,103.34693877551021,37.877551020408156,27.285714285714285
Ireland,2014,14,2014-03-31,20148,35242,173777,30273,259440,3,1,32,3,39,134.67346938775512,78.00000000000001,30.081632653061224
Ireland,2014,15,2014-04-07,19969,34929,172234,30004,257136,2,6,12,0,20,123.2857142857143,60.183673469387756,11.653061224489793
Ireland,2014,16,2014-04-14,20148,35242,173777,30273,259440,0,3,7,1,11,138.67346938775512,51.85714285714285,6.836734693877552
Ireland,2014,17,2014-04-21,19853,34726,171232,29830,255641,0,0,7,1,8,142.28571428571428,72.08163265306123,23.163265306122447
Ireland,2014,18,2014-04-28,20148,35242,173777,30273,259440,0,0,5,2,7,148.57142857142858,81.06122448979593,19.387755102040813
Ireland,2014,19,2014-05-05,20148,35242,173777,30273,259440,0,0,0,0,0,140.40816326530611,82.38775510204081,46.81632653061224
Ireland,2014,20,2014-05-12,19079,33371,164554,28667,245671,0,0,3,0,3,156.32653061224488,83.73469387755104,24.77551020408163
Ireland,2014,21,2014-05-19,20148,35242,173777,30273,259440,0,0,3,0,3,146.9183673469388,85.48979591836735,34.26530612244898
Ireland,2014,22,2014-05-26,20148,35242,173777,30273,259440,0,2,5,0,7,168.3877551020408,89.48979591836735,11.530612244897961
Ireland,2014,23,2014-06-02,19983,34953,172356,30026,257318,0,0,3,0,3,164.87755102040816,96.6734693877551,24.36734693877551
Ireland,2014,24,2014-06-09,20148,35242,173777,30273,259440,0,0,1,0,1,184.40816326530611,113.42857142857143,17.142857142857142
Ireland,2014,25,2014-06-16,20148,35242,173777,30273,259440,0,0,6,1,7,198.6938775510204,111.81632653061224,3.8775510204081636
Ireland,2014,26,2014-06-23,19964,34919,172186,29996,257065,0,0,1,0,1,184.28571428571428,113.42857142857143,18.73469387755102
Ireland,2014,27,2014-06-30,19964,34919,172186,29996,257065,0,0,1,0,1,188.26530612244898,110.73469387755101,24.183673469387752
Ireland,2014,28,2014-07-07,19993,34970,172437,30040,257440,0,0,2,1,3,188.10204081632654,121.89795918367348,21.102040816326532
Ireland,2014,29,2014-07-14,19255,33680,166074,28931,247940,0,1,0,1,2,201.91836734693877,134.3061224489796,22.6734693877551
Ireland,2014,30,2014-07-21,20148,35242,173777,30273,259440,0,1,1,0,2,223.18367346938774,143.65306122448982,12.591836734693876
Ireland,2014,31,2014-07-28,20148,35242,173777,30273,259440,0,0,0,0,0,189.3265306122449,130.95918367346937,48.89795918367348
Ireland,2014,32,2014-08-04,19985,34957,172374,30029,257345,0,0,0,0,0,195.02040816326533,119.22448979591836,49.673469387755105
Ireland,2014,33,2014-08-11,20148,35242,173777,30273,259440,0,0,1,0,1,179.20408163265307,116.53061224489795,19.73469387755102
Ireland,2014,34,2014-08-18,20148,35242,173777,30273,259440,0,0,2,0,2,168.14285714285714,92.65306122448979,17.57142857142857
Ireland,2014,35,2014-08-25,20148,35242,173777,30273,259440,0,0,3,0,3,178.75510204081633,123.20408163265306,30.653061224489797
Ireland,2014,36,2014-09-01,19798,34629,170758,29747,254932,0,0,2,0,2,182.40816326530617,113.73469387755101,6.816326530612245
Ireland,2014,37,2014-09-08,18611,32553,160521,27964,239649,0,1,5,0,6,189.75510204081633,95.24489795918366,4.448979591836735
Ireland,2014,38,2014-09-15,19446,34014,167723,29218,250401,0,0,2,0,2,183.44897959183672,114.06122448979592,11.387755102040817
Ireland,2014,39,2014-09-22,18937,33123,163332,28454,243846,0,0,6,1,7,175.81632653061226,104.61224489795919,15.836734693877549
Ireland,2014,40,2014-09-29,20473,35809,176575,30761,263618,0,0,4,1,5,161.73469387755102,99.55102040816327,50.57142857142857
Ireland,2014,41,2014-10-06,20750,36294,178968,31178,267190,1,1,15,0,17,141.9591836734694,64.36734693877551,29.591836734693878
Ireland,2014,42,2014-10-13,20750,36294,178968,31178,267190,0,0,11,0,11,151.26530612244895,92.73469387755101,37.55102040816326
Ireland,2014,43,2014-10-20,20422,35721,176141,30685,262969,0,0,13,2,15,138.26530612244898,87.53061224489797,25.71428571428571
Ireland,2014,44,2014-10-27,20331,35562,175358,30549,261800,0,0,12,0,12,142.73469387755102,92.04081632653062,53.95918367346939
Ireland,2014,45,2014-11-03,20164,35269,173912,30297,259642,1,0,10,2,13,116.69387755102039,53.08163265306122,61.85714285714287
Ireland,2014,46,2014-11-10,19661,34390,169577,29542,253170,1,1,11,2,15,115.65306122448979,59.938775510204074,73.36734693877551
Ireland,2014,47,2014-11-17,19223,33624,165799,28883,247529,3,0,12,3,18,108.93877551020408,54.61224489795918,37.673469387755105
Ireland,2014,48,2014-11-24,18997,33227,163845,28543,244612,1,0,19,0,20,100.63265306122449,39.0,11.183673469387754
Ireland,2014,49,2014-12-01,20199,35331,174218,30350,260098,1,1,17,3,22,85.38775510204081,35.775510204081634,25.183673469387752
Ireland,2014,50,2014-12-08,20750,36294,178968,31178,267190,3,4,27,5,39,83.71428571428571,26.10204081632653,47.734693877551024
Ireland,2014,51,2014-12-15,19153,33501,165192,28778,246624,4,2,17,5,28,103.0204081632653,55.57142857142856,51.3673469387755
Ireland,2014,52,2014-12-22,20505,35867,176859,30810,264041,2,3,12,3,20,82.6938775510204,44.51020408163265,39.387755102040806
Ireland,2015,1,2014-12-29,20565,35972,177377,30900,264814,2,0,29,10,41,96.32142857142857,44.607142857142854,46.714285714285715
Ireland,2015,2,2015-01-05,20571,35982,177425,30909,264887,1,4,65,10,80,102.08163265306123,43.12244897959183,57.06122448979592
Ireland,2015,3,2015-01-12,20175,35289,174011,30314,259789,3,5,62,9,79,67.75510204081634,16.77551020408163,53.93877551020408
Ireland,2015,4,2015-01-19,20750,36294,178968,31178,267190,7,9,62,5,83,78.08163265306122,12.857142857142856,26.979591836734695
Ireland,2015,5,2015-01-26,20635,36093,177973,31004,265705,5,11,74,9,99,68.87755102040816,28.0,27.265306122448983
Ireland,2015,6,2015-02-02,20635,36093,177973,31004,265705,4,10,71,13,98,65.48979591836734,4.816326530612246,8.857142857142858
Ireland,2015,7,2015-02-09,20750,36294,178968,31178,267190,4,30,134,20,188,79.51020408163265,29.224489795918366,23.836734693877553
Ireland,2015,8,2015-02-16,20750,36294,178968,31178,267190,9,22,117,13,161,89.16326530612244,32.204081632653065,33.61224489795918
Ireland,2015,9,2015-02-23,20381,35649,175786,30623,262439,8,23,91,12,134,89.81632653061224,34.97959183673469,44.714285714285715
Ireland,2015,10,2015-03-02,20271,35457,174837,30458,261023,2,9,58,8,77,98.0,43.673469387755105,30.08163265306123
Ireland,2015,11,2015-03-09,19910,34825,171723,29915,256373,0,7,61,15,83,103.73469387755101,22.448979591836736,31.551020408163264
Ireland,2015,12,2015-03-16,20750,36294,178968,31178,267190,2,2,46,7,57,109.40816326530611,28.714285714285715,5.387755102040816
Ireland,2015,13,2015-03-23,20243,35408,174599,30416,260666,3,5,37,1,46,108.20408163265304,41.306122448979586,40.163265306122454
Ireland,2015,14,2015-03-30,20177,35292,174026,30317,259812,0,2,25,4,31,115.75510204081634,52.57142857142857,30.142857142857142
Ireland,2015,15,2015-04-06,20750,36294,178968,31178,267190,2,3,29,3,37,143.79591836734696,40.183673469387756,22.795918367346935
Ireland,2015,16,2015-04-13,20750,36294,178968,31178,267190,1,1,28,2,32,136.55102040816328,50.46938775510204,5.632653061224489
Ireland,2015,17,2015-04-20,20588,36011,177570,30934,265103,1,1,14,3,19,139.67346938775512,48.91836734693878,14.224489795918368
Ireland,2015,18,2015-04-27,20052,35073,172946,30128,258199,0,0,10,0,10,120.57142857142857,42.163265306122454,62.57142857142857
Ireland,2015,19,2015-05-04,19996,34976,172469,30045,257486,0,0,6,2,8,131.53061224489798,68.22448979591836,60.95918367346938
Ireland,2015,20,2015-05-11,20750,36294,178968,31178,267190,0,0,6,1,7,140.91836734693877,72.48979591836734,20.571428571428573
Ireland,2015,21,2015-05-18,20750,36294,178968,31178,267190,0,2,6,1,9,146.16326530612244,78.91836734693878,17.612244897959183
Ireland,2015,22,2015-05-25,20750,36294,178968,31178,267190,0,0,4,0,4,140.3469387755102,75.79591836734694,33.57142857142857
Ireland,2015,23,2015-06-01,20750,36294,178968,31178,267190,0,0,3,0,3,149.0612244897959,77.87755102040818,29.775510204081634
Ireland,2015,24,2015-06-08,20423,35723,176151,30687,262984,0,0,7,0,7,166.06122448979593,78.22448979591836,3.897959183673469
Ireland,2015,25,2015-06-15,20090,35141,173280,30187,258698,0,0,3,0,3,174.18367346938774,107.38775510204081,14.48979591836735
Ireland,2015,26,2015-06-22,20750,36294,178968,31178,267190,0,2,3,0,5,184.67346938775512,112.87755102040816,16.387755102040817
Ireland,2015,27,2015-06-29,20244,35409,174602,30417,260672,0,0,0,0,0,200.26530612244898,130.9795918367347,28.73469387755102
Ireland,2015,28,2015-07-06,19886,34783,171516,29879,256064,0,0,1,0,1,178.3265306122449,118.79591836734694,38.04081632653061
Ireland,2015,29,2015-07-13,20750,36294,178968,31178,267190,0,0,3,0,3,175.75510204081633,110.81632653061224,41.44897959183673
Ireland,2015,30,2015-07-20,20020,35017,172668,30080,257785,0,0,0,1,1,170.63265306122452,109.42857142857143,27.020408163265305
Ireland,2015,31,2015-07-27,19591,34268,168974,29437,252270,0,0,2,0,2,169.0408163265306,107.06122448979592,31.938775510204078
Ireland,2015,32,2015-08-03,19828,34682,171018,29793,255321,0,0,0,1,1,177.12244897959184,112.9183673469388,38.775510204081634
Ireland,2015,33,2015-08-10,20610,36050,177762,30968,265390,0,0,2,0,2,177.71428571428572,104.24489795918369,11.16326530612245
Ireland,2015,34,2015-08-17,20167,35276,173944,30302,259689,0,0,2,0,2,189.71428571428572,123.12244897959182,46.816326530612244
Ireland,2015,35,2015-08-24,20422,35721,176141,30685,262969,0,1,0,0,1,177.51020408163268,106.65306122448979,33.87755102040816
Ireland,2015,36,2015-08-31,20750,36294,178968,31178,267190,0,1,3,1,5,158.77551020408166,97.89795918367346,10.244897959183673
Ireland,2015,37,2015-09-07,20267,35450,174805,30452,260974,1,2,5,2,10,171.12244897959184,111.6938775510204,46.204081632653065
Ireland,2015,38,2015-09-14,19000,33234,163877,28549,244660,0,0,8,0,8,158.85714285714286,96.6938775510204,24.408163265306126
Ireland,2015,39,2015-09-21,18545,32438,159953,27865,238801,0,0,9,1,10,160.59183673469389,90.75510204081631,16.0
Ireland,2015,40,2015-09-28,20408,35697,176021,30664,262790,0,0,10,1,11,159.28571428571428,80.02040816326532,10.755102040816327
Ireland,2015,41,2015-10-05,20750,36294,178968,31178,267190,1,0,9,1,11,157.36734693877548,93.3265306122449,16.571428571428573
Ireland,2015,42,2015-10-12,20750,36294,178968,31178,267190,0,2,8,0,10,135.77551020408163,61.816326530612244,5.469387755102041
Ireland,2015,43,2015-10-19,20750,36294,178968,31178,267190,0,1,10,1,12,133.59183673469386,78.65306122448979,40.42857142857143
Ireland,2015,44,2015-10-26,20750,36294,178968,31178,267190,2,1,5,0,8,142.10204081632654,85.95918367346938,40.6530612244898
Ireland,2015,45,2015-11-02,19467,34051,167905,29250,250673,0,1,9,0,10,136.6122448979592,82.51020408163266,44.18367346938776
Ireland,2015,46,2015-11-09,20750,36294,178968,31178,267190,1,1,9,1,12,134.55102040816323,71.57142857142857,80.36734693877551
Ireland,2015,47,2015-11-16,20750,36294,178968,31178,267190,0,2,15,2,19,101.22448979591836,52.14285714285713,40.97959183673469
Ireland,2015,48,2015-11-23,20750,36294,178968,31178,267190,0,0,16,2,18,107.61224489795919,56.26530612244898,57.551020408163254
Ireland,2015,49,2015-11-30,20423,35723,176151,30687,262984,1,2,17,3,23,115.40816326530613,59.83673469387755,108.77551020408164
Ireland,2015,50,2015-12-07,20635,36093,177973,31004,265705,2,0,25,2,29,102.93877551020408,46.48979591836734,77.93877551020408
Ireland,2015,51,2015-12-14,20635,36093,177973,31004,265705,1,3,25,7,36,122.14285714285714,86.18367346938776,41.57142857142857
Ireland,2015,52,2015-12-21,22151,38744,191048,33282,285225,0,6,11,2,19,99.10204081632652,43.59183673469387,65.22448979591837
Ireland,2015,53,2015-12-28,22151,38744,191048,33282,285225,2,4,23,1,30,104.82142857142857,52.464285714285715,110.60714285714286
